xxxxxxxxxxxxxxxxxxxxxxxxxxxxxxxxxxxxxxx
x        x                            x
x p      x                            x
x                                     x
x                                     x
x                                     x
x                     x               x
x                     x               x
x                     x               x
x                     x               x
x                x    x               x
x                xxxxxx               x
x                                     x
x                                     x
x                                     x
x                                     x
x                                     x
x                                     x
x                                     x
xxxxxxxxxxxxxxxxxxxxxxxxxxxxxxxxxxxxxxx
